ls 		>>	listout files;
ls -al 		>>	listout (include hidden files);
pwd		>>	present working directory;
cd ..		>>	one step back;
cd home/	>>	redirect to home directory;
mkdir		>>	create directory/folder;
touch		>>	create file;
cat		>>	to read inside of the file;
cat > fname	>>	create & write inside file;
cntrl + D	>>	to exit from writing mode;
rm		>>	removes file;
rm -r		>>	removes folder;
rm --help	>>	command narration;
cp oName nName	>>	copy content to new file;
cp sPath dPath	>>	copy file from source to destination;
cp -r sPath dPath	>>	copy folder to destination path;
mv sPath dPath	>>	cut & paste (can rename the file);
rmdir		>>	

chmod
grep
user maintanance
installing

ðŸ”¹ File and Directory Commands
Command		Description
ls		List directory contents
pwd	Print current working directory
cd [dir]	Change directory
mkdir [dir]	Create a new directory
rmdir [dir]	Remove an empty directory
rm [file]	Delete a file
rm -r [dir]	Delete a directory and its contents
cp [src] [dest]	Copy files or directories
mv [src] [dest]	Move or rename files
touch [file]	Create an empty file
cat [file]	View file content
more [file] / less [file]	View file content one screen at a time
head [file]	View first 10 lines of a file
tail [file]	View last 10 lines of a file

ðŸ”¹ File Permissions
Command	Description
chmod [permissions] [file]	Change file permissions
chown [owner] [file]	Change file owner
chgrp [group] [file]	Change file group
ls -l	List with permissions

ðŸ”¹ Process Management
Command	Description
ps	Show running processes
top	Real-time process monitoring
htop	Interactive process viewer (needs installation)
kill [PID]	Terminate a process by PID
killall [name]	Kill all processes by name
nice / renice	Set process priority
&	Run a command in background
jobs	Show background jobs
fg / bg	Resume jobs in foreground/background

ðŸ”¹ Disk and Filesystem
Command	Description
df -h	Show disk usage
du -sh [dir/file]	Show size of a file or directory
mount / umount	Mount or unmount drives
fsck	Filesystem check
mkfs	Create filesystem
blkid	Display block device info

ðŸ”¹ User Management
Command	Description
adduser [user]	Add new user
passwd [user]	Change user password
deluser [user]	Delete a user
whoami	Show current user
id	Show user/group info
su [user]	Switch user
sudo [command]	Run command as superuser

ðŸ”¹ Networking
Command	Description
ip a or ifconfig	Show IP address (ip is newer)
ping [host]	Ping a host
netstat -tuln	Show listening ports
ss -tuln	Faster alternative to netstat
curl [url]	Fetch a URL
wget [url]	Download file from a URL
scp	Secure copy over SSH
ssh [user@host]	SSH into a remote server
traceroute [host]	Show path to a host

ðŸ”¹ Search & Text Processing
Command	Description
grep '[pattern]' [file]	Search in a file
find [dir] -name [name]	Find files by name
locate [name]	Quickly locate a file (uses index)
awk	Pattern scanning and processing
sed	Stream editor (e.g., find and replace)
cut, sort, uniq	Text filtering and processing

ðŸ”¹ Package Management
(Varies by distribution)

System	Commands
Debian/Ubuntu	apt, dpkg
RedHat/CentOS	yum, dnf, rpm
Arch	pacman
Example:

sudo apt update && sudo apt upgrade

sudo dnf install [package]

sudo pacman -S [package]

ðŸ”¹ System Information
Command	Description
uname -a	Show system info
uptime	Show system uptime
free -h	Show memory usage
top / htop	Monitor system resources
vmstat	Report on processes/memory
lscpu	Show CPU info
lsblk	Show block devices
dmesg	System boot and hardware messages

ðŸ”¹ Compression and Archiving
Command	Description
tar -czf file.tar.gz [dir]	Create compressed archive
tar -xzf file.tar.gz	Extract archive
zip / unzip	Compress or extract zip files
gzip / gunzip	Compress or decompress .gz files

ðŸ”¹ Miscellaneous
Command	Description
history	Show command history
alias ll='ls -al'	Create a command alias
date	Show current date and time
cal	Display calendar
man [command]	Show manual page


